1111111111
1000000001
1000000001
100CPE0001
1111111111