11111111111111
1P0000001C0001
10111100100001
1000C100000E01
11111111111111
