1111111111
1000C00C01
100E000001
1P00000001
1111111111