111111111111111111
1E10001C010000C1C1
1P1C10010000010101
10001C00010001C001
111111111111111111