111111111
101000101
1P0C000E1
10001C001
111111111