1111111111
1P000000C1
1000000001
10000100E1
1111111111