11111111111111
1P000001C00001
10000001110111
10000000000001
10000000000001
10111100000001
1000C100000E01
11111111111111